SENTENCE 1: Csrc = although (althoughCONCESSION)	Cref = fy Hyn	Ccand = Ely Alrgm	==> case 2: Synonym connectives in Ref and Cand ==>likely ok !  
SENTENCE 2: Csrc = although (althoughCONCESSION)	Cref = Ely Alrgm	Ccand = rgm	==> case 2: Synonym connectives in Ref and Cand ==>likely ok !  
SENTENCE 3: Csrc = although	Cref = An lm	Ccand = 0	==> case 4: Not translated in Cand ==> likely not ok 
SENTENCE 4: Csrc = eventhough	Cref=Ccand = Ely Alrgm	==> case 1: Same connective in Ref and Cand ==>likely ok ! 
SENTENCE 5: Csrc = eventhough	Cref =  mE An	Ccand = Alrgm	==> case 3: Incompatible connectives 
SENTENCE 5: Csrc = eventhough	Cref =  mE An	Ccand = Alrgm	==> case 3: Incompatible connectives 
SENTENCE 6: Csrc = eventhough (eventhoughCONCESSION)	Cref = rgm	Ccand = Ely Alrgm	==> case 2: Synonym connectives in Ref and Cand ==>likely ok !  
SENTENCE 7: Csrc = meanwhile	Cref=Ccand = fy Alwqt nfs	==> case 1: Same connective in Ref and Cand ==>likely ok ! 
SENTENCE 8: Csrc = meanwhile (meanwhileTEMPORAL)	Cref = fy Alwqt AlHADr	Ccand = fy Alwqt nfs	==> case 2: Synonym connectives in Ref and Cand ==>likely ok !  
SENTENCE 9: Csrc = meanwhile	Cref = 0	Ccand = fy Alwqt nfs	==> case 5: Not translated in Ref but translated in Cand==> indecide, to check by Human 
SENTENCE 10: Csrc = since (sinceCAUSAL)	Cref = nZrA	Ccand = mA An	==> case 2: Synonym connectives in Ref and Cand ==>likely ok !  
SENTENCE 11: Csrc = since	Cref = Hyv	Ccand =  mn*	==> case 3: Incompatible connectives 
SENTENCE 12: Csrc = since (sinceCAUSAL)	Cref = Hyv	Ccand = mA An	==> case 2: Synonym connectives in Ref and Cand ==>likely ok !  
SENTENCE 13: Csrc = though (thoughCONCESSION)	Cref = An kAnt	Ccand = rgm	==> case 2: Synonym connectives in Ref and Cand ==>likely ok !  
SENTENCE 14: Csrc = though	Cref=Ccand = rgm	==> case 1: Same connective in Ref and Cand ==>likely ok ! 
SENTENCE 15: Csrc = though	Cref = 0	Ccand =  mE	==> case 5: Not translated in Ref but translated in Cand==> indecide, to check by Human 
SENTENCE 16: Csrc = while	Cref =  mE An	Ccand = 0	==> case 4: Not translated in Cand ==> likely not ok 
SENTENCE 17: Csrc = while	Cref = A*A	Ccand = 0	==> case 4: Not translated in Cand ==> likely not ok 
SENTENCE 18: Csrc = while	Cref=Ccand = fy Hyn	==> case 1: Same connective in Ref and Cand ==>likely ok ! 
SENTENCE 19: Csrc = notyet	Cref=Ccand = bEd	==> case 1: Same connective in Ref and Cand ==>likely ok ! 
SENTENCE 20: Csrc = yet	Cref = Ely An	Ccand = 0	==> case 4: Not translated in Cand ==> likely not ok 
****************************** 

 Done in  0 seconds
